Month,Year,Faulty Program,Meter Complaint,Meter Leak,Total
03,2022,8000,1800,18000,27800
04,2022,12000,1900,16000,29900
05,2022,11000,1650,17000,29650
06,2022,7800,1500,17000,26300
07,2022,16000,2000,18000,36000
08,2022,5000,2000,18000,25000
09,2022,11000,2000,17000,30000
10,2022,16000,1500,15000,32500
11,2022,9200,2000,19000,30200
12,2022,7500,1600,17000,26100
01,2023,6000,1600,16000,23600
02,2023,6000,1400,18000,25400
03,2023,9625,1746,17167,28538